%%%%%%%%%%%%%%%%%%%%%%%%%%%%%%%%%%%%%
%                                  P%
% %%%%%%%%%%%%%%%%%%%%%%%%%%%%%%%%%%%
%                                   %
% %%%%%%%%%%%%%%%%%%%% %%%%%%%%%%%% %
%                                   %
% %%%%%%%%%%%%%%%%%%%%%%%%%%%%%%%%%%%
%                                   %
%%%%%%%%%%%%%%%%%%% %%%%%%%%%%%%%%% %
%                                   %
% %%%%%%%%%%%%%%%%%%%%%%%%%%%%%%%%%%%
%                                   %
%%%%%%%%%%%%%%%%%%%%%%%%%%%%%%%%%%% %
%.                                  %
%%%%%%%%%%%%%%%%%%%%%%%%%%%%%%%%%%%%% 
