%%%%%%%%%%%%%%%%%%%%%%%%%%%%%%
% %        % %%%    % %% %% P%
%%   %%    %  %       %      %
%  %       %     %   %       %
%   %%    %%                 %
%     % %   % %%   %       % %
%  %                %%       %
%  % %%  %    %  %%          %
%  %   %%  %  %% % %% % %   %%
%%%    %   %       %%      %%%
%                  % % %  %  %
%    % %  %%    %%   %       %
%                      %%   %%
% %%   %%%      %            %
%      % %%%    %       %%   %
%      %      %      %%      %
%   %    %  %     %   %%     %
%       %%         %         %
%  %    % %      %   %   %   %
% % %   %   % %%%% %    %    %
% %       % %       %%    %  %
%  % % %   %         %   %   %
%       %  % %  % %%   %%  % %
%          %  %     %%       %
%   %%%       %   %        % %
%%%     %         %       % %%
%  % %   %%     %     % %    %
%         % %     %    %    %%
%.% %   %       %      %  %%%%
%%%%%%%%%%%%%%%%%%%%%%%%%%%%%%
