%%%%%%%%%%%%%%%%%%%%%%%%%%%%%%
%   % %     %     %        %P%
% %       %% %       %       %
% %  %%%%  % %       %%  %   %
%   %   %%   %      %     %  %
% %%        %               %%
%    %     %    %     %      %
%%    %  %    %     %  %   % %
%   % %%         %%%%     %% %
%  % %  %        %   %  %%   %
%  %     % %     % % %       %
%    %%                  %  %%
%    %  %% %  %   %    %  %  %
%   %   %   %   %%   %     % %
%       %   %  %     %      %%
%      %   % %     %         %
%%%%%%%      %   % %         %
%    %%         %  %%    %   %
%  %        % %   %    %%  % %
%%   %%%   %     %    % %    %
%%%             %  %% %    % %
% % %%      %       %   %    %
%   %        %  %         %% %
%    % % %        % %      % %
%        %     %     % %  %%%%
% %      %% % % %% %   %     %
%  %   %    %               %%
%          % %     % %%%%    %
%.  %%          %          %%%
%%%%%%%%%%%%%%%%%%%%%%%%%%%%%%
